{
  "width": 7,
  "height": 5,
  "tiles": [
    "#######",
    "#.....#",
    "#..P..#",
    "#.....#",
    "#######"
  ]
}
